T-S NS 184.58 1 recto


מעשה שהיה לפנינו אנו שני הדיינים הקבועים בפסטאט מצרים ומאן דחתים עימנא


לתחתא כן הוה חצר אלינא אלשיך אבו אסחק מר' | ור' אברהם היקר יש' צו' בר כג''ק מר' ור' יצחק 


הזקן הנכבד נ''ע וקאל לנא לי זכות וראיה ואונא אותר מן בית דין אסתמאעהא ואתבאתהא


ליכון | לי לזכו ולראיה ואחצר אלינא מר' ור' מש|ה הזקן בר מר' ור' נסים הזקן נ''ע ומר' ור' יוסף בר 


מר' ור' נסים הזקן דידיע | ובן אלקלאל ס''ט ושהדא | בין ידינא שהאדה ואחדה מתפקה וקאלא לנא


למא דנת ואלדה אלשיך אבו אסחק דנן | ואלופאה חצר אלינא וקאל לנא מא יכפא ענכם אנני


כנת פי חאל חיאה ואלדתי מקימא פי מנזל | וכאלי אלשיך אבו יעקוב דידיע אללבדי נ''ע וכאן


יחמלני אלי אלדכול ואלכרוג' אליהם כון ואלדתי באלחיאה ואליום קד בקית וחיד ומא לי וגה אלי אל 


עודה אלי מא כנת עליה מן אלדאלה מן אלד|[... פ]|קד אשתהית אלאתצאל באבנה 


כאלי ואן יכון דלך עלי ידיכם ואכון באקי | עלי מא כנת עליה מן צחבתהם פמצינא גמיעא


ומענא חצרה אלרייס אלג'ליל אבו סעד אלא|[...]עי יזכר בטוב וכאטבנא גמיע זוגה אלשיך 


אבו יעקוב נ'|'ע עלי דלך פאנעמת בזיג'ה אובנתהא ללשיך אבו אסחק אברהם דנן וקאלת מא 


ענדי אעז מנה בל מא אזוגהא | אלי חי|ן| וצול אכיהא פאגאבהא אלרייס אלמדכור וקאל מא ימכן 


מג'ינאי ונכרג' ומא קצינא חאג'ה אמלכיהא | בקידושים ואבקי דכולהא אלי חין וצול ולדך


פאנעמת לה בדלך ואסתשרנא אלצביה ס|ת אלאהל אלמדכורה אבנה אלשיך אבו יעקוב


עלי דלך פאנעמת איצא לאננא נדל עליהא בוקו|פהא בין ידינא ולמערפתנא להא אלמערפה 


אלצחיחה פלמא אג'אב כל מנהמא אלי דלך אק|נינא מן | אלשיך אבו אסחק דנן בקנין גמור


חמור בכלי הכשר לקנות בו מעכשו בבי|טול כל מודעין ו|תנאין אנה קד והב מולאי אלרייס


דנן ארבע אמות מחלקו בארץ ישראל | ובמתנה ואצאף אלי דלך | באן וכלה עלי אן יקדס לה אבנה 


כאלה סת אלאהל דא אובנה אלשיך אבו יעקוב כאלה נ''ע על שם קידושים גמורים ודפע לה


כמסה דנאנ|ניר וכאתמין כאתם דהב וכאתם פצה ובעד דלך ר|גענא אלי אלצביה ואקנינא 


מנה|א בעד צחה מערפתנא בהא בחצרה ואלדתהא ורצאהא ובח|צרה אכיהה | ורצאה


איצא בקנין גמור חמור בכלי הכשר לקנות בו מעכשו בב|יטול כל מודעין ותנאין אנהא קד


מלכת נפסהא ללשיך אבו אסחק דנן וקלנא להא | קדסי נפסך ללשיך אבו אסחק דנן בן עמ[תך]


בהדה אלכמסה דנאניר ואלכאת|מ]ין אלמרסלה על יד מולאי אלרייס יש' צו' בקידושים גמורים 


כתורה וכהלכה |... ובעד דלך] קבצת גמיע דלך מן ידינא וקאלת קד קדסתה נפסי


בדלך מעכשו.|[ו... ]אנהא באלגה מאלכה נפסהא ואותק אלרייס אלמדכור


אלמלאך בקידושים | [גמורים ...]ה תלמיד חכמים ותיק ולמא צארת בדלך זוג'תה


ובעצמתה שכרנא אללה | [תעאלי ...אן] אנחכם אלאמר עלי ידינא ואנצרפנא     והדא אלדי


נשהד בה אלשהאדה אלקאטעה אלדי לא פסך פויהא ולא ארתיאב בהא ונחקה ונקטע אלשהאדה


בה וכאן דלך פי אל חדש כסלו מן אלסנה | אלכארגה אלתי הי סנה את''ל ומה דאשהידו קדמנא


כתבנא וחתמנא דליהוי לזכו ולראיה ואנהא קד צארת בחזקת אשת איש וכאן דלך


יום אחד אלאחד אלתאסע מן חדש שבט שנת | אתל''א [לשטרות בפסטאט מצרים]


דעל נילוס נהרא מותב[ה] 


 