II, 60

מן צמאן דרכה ואחריות זבינין | אילין עלאי אנא ישועה הלוי ועלי ואלדתי
מוכלתי ועלי וראתנא בעדנא ע|ל כל שפר ארג נכסין קנין וממון דאית
לנא ודיהוי לנא תחות כל שמיא| בביתא ובברא ממקרקעי וממטלטלי
ואפילו מגלימא דעל כתפנא | דלא כאסמכאתא דלא כטופסי דשטרי
אילא כחומר וכחוזק כל שטרי | מחזקי מזרזי דבי דינא ותקנאתא דרבנן
עלי מא תקדם אלשרח פי דלך ל|עילא וליס לאחדנא אלרגוע פי דלך גמיעה
בטלב אד קד צאר כל חק לנא | פיה לכגק מר ור מחרוז דנן ולא לאחד
פסך שי מן דלך ולא קבול זיא|דה עליה פיה ולא אענאתה ולא אלרגוע
עלי אחד ממן יתסלם מנה ש|י מן דלך בטלב אד לה מעכשו אלתצרף
פי גמיע דלך תצרף אלמלאך | ולמקנא ולאקנואה ולאורותא ולאחסונא
ולזבונא ולחלופא ולמיהב ב|מתנה לכל מאן דיצבי ואנש לא ימחא
בידיה ולא ביד ירתיה בתריה |מן שמנא מן יומא דנן ולעלם אד קד
מלך דלך מנא וצאר לה ו|לה כל חק לנא פיה כאין מא כאן ובאלג מא
בלג וכתבת לה הדא אלכת|אב ליכון בידה וביד וראתה בעדה
עלי אנא ישועה הלוי ועלי | ואלדתי לולוה מוכלתי ועלי גמיע וראתנא
בעדנא אריך ושריר ו|קיים ומוחזק דיזכון ביה בכל בתי דינין לעלם
לא כאלאסנאדאת ולא | כמצאדיר אלכתב אלא כאוכד ואתקן מא סטרוה
רבותינו זל פי כתב אל|ביוע ואלאשריה ובטילית נמי כל מודעין ותנאין
[[דמסירין לנא אנא וואל|דתי מוכלתי לי ודמ]] ומודעי דמודעי ומודעי
דנפקין מגו מודעי | עד סוף כל מודעי דמסירין לי ודמסרנא

TS NS 184 52 verso + TS NS 184 55

על שטרא דנן כתיקון חכמים | זל וכל כתבי בכל כתב ולשון דיפקון
למדעם ולבטולא ית שטר זבי|ני אילין בטילין אנון מעכשו קדמתון
וחשיבין כחספא בשוקא דל|ית ביה ממש ולכל בית דין דיפקון
לא ליעבדון דינא מנהו|ן ואקנינא אנן חתומי מטה
מן אבו אלפרג ישועה ה|לוי אפטרופא דנן ביר אברהם נע
לכגק מר ור מחרוז הזק|ן הנכבד דנן בר כגק מר ור יעקב
השר הנכבד החסיד זל | עלי גמיע דלך בקנין גמור חמור
בכלי הכשר לקנות בו | מעכשו בביטול כל מודעין ותנאין
ושהדותא דא כתבנא ו|חתמנא ויהבנא לכגק מר ור מחרוז
דנן דליהוי בידיה לזכו | ולראיה וכאן דלך יום אל דהוא
כך וכך יומי בחדש פל | דשנת אלפא וארבע מאה וארבעין
ותלתה שנין למנין שטרו|ת בפסטאט מצרים דעל נילוס נהרא
מותבה רשותיה דאדוננ|ו מצליח כהן ראש ישיבת גאון יעקב
יהי שמו לעולם כירח | יכון עולם שריר ובריר וקיים
