Recto
 


כתיב יום ב׳ כ״ב לחודש | [ר]חמים שנת התקצה לפ״ק


ראשית דברי בקידה ובהש|תחויה למאור הגדול מורינו ורבינו ועטרת ראשנו הרב


הגדול מעוז ומגדול המל|ך שלמה רעיא מהי{מ}נאה הי״ו אכי״ר


אֿנֿעֿרֿוֿ גביר לאדוני על כל . . | שירע (=שארע) לי מיום שיצאתי מעיר ירושלים עיר הקודש תוב״ב הלכתי


לעיר גיזה ומאצתי עריל|ים של בית לחם ושכרתי עמהם לעיר איסויס והגעתי לסויס


שלים בלא שום פגע ר|ע ברוך ה׳ ואחר כך ישבתי פלאק(?) אלא נפלתי בחולי הקדחת כד׳


ישעות(?) שלא נדע בעול|ם כלל אם חי אם מת ואחר שנשיב נמצא עצמי מלוכלך 


והייתי נותן לגויה אח|ת שכרה גרוש אחד בכל יום לרחוץ הבגדים הצואים בים היה


זה כמו כ״ה יום ויום ש|נסכנסתי (=שנכנסתי) מצאתי חולי המגפה והשר של עיר היה בחוץ והרעלים (=והערלים)


ברחו ואוניות מופעם(?) | לילך לעיר גידא והיו מלאים כולם באנשי חיל ולא הניחו אותי


לילך עמהם אחר זה ש|כרתי בספינה כדי לילך ולקחתי כל ביגדי ורכבתי וישבתי בלילה 


בתוך הספינה בשחרי|ת בא שר אחד והוריד אותי ואת הגוים אשר היו אתי אנשי 


דמשק וחזרתי לעיר | ומזה הלך לי חולה הקדחת אחר זה מרוב החמימות שהיה לי שרף 


כל גופי ובפרט ד|בק לשוני לחכי והלכתי לרופא ורפא אותי שנית בין כך ובין כך המעות


אשר היו עמי נש|למו ואני מיית ברעב ובצמא ובחוסר כל אחר כך בא הערל שאני


מכיר אותו והלכתי א|צלו ונפלתי על רגליו שירכיב אותי באוניה שלו והבטחני


//שישלח אותי// אחר זה נפלתי בחולי | עינים וישבתי כ״ב שלא יפתח הבית עלי ומי שיעשה איזה דבר


יקח כפלים יבא פנזא|ל(?) קוייא בה׳ פרות יקח ה׳ פרות וכן על זה הדרך והייתי מיית


ברעב עד שעשו עמי | שני ערלים צדקה א׳ נתן ה׳ גרושיש והב׳ נתן י׳ גרושיש בקצור


בא זמן הספינה של | ערל שאמר שישלח אותי לקחו הספינה שלם(?) ולא שלח אותי


אחר כך נזדמנו ג׳ ספ|ינות של השר הלכתי לשר העיר לפייס אותו שישלח אותי


בספינה אמר לי תקן שכי|רות כתילך(?) כה בקשתי ליקח פוליסה לעיר ירושלים ולא מצאתי 


אחר כך נתתי דעתי על | מצרים ושלחתי פוליסה על הערל כ״ה רייל למעלים בכור


עליון ולס׳ ח״ר מרכדו | אלגזי ולא נתנו(?) לי תשובה אחר כך אמר לי הערל עד מתי


תישן בכאן תמות ברעב | קום לך למצרים אתה בעצמך ותביא מעות כדי שתליך בקצור


קמתי ובאתי למצרים | והלכתי לבית ס׳ הרב ח״ר מרכדו אלגזי וספרתי לו כל 


המהורע (=המאורע) שירע (=שארע) לי וא|מר לי זה הענין אינו בידי תליך אצל מעלים בכור והוא יצל


אותך הלכתי אצלו ו|ספר לי על הכתב ששלחתי לו מן הסויס ואמר לי בכאן לא


תמצא אפליו (=אפילו) פרוטה | אמרתי לו אני שליח של כולל אמר לי תביא הכתבים


אמרתי לו עכשיו נ|ביא אותם אמר לי לעת ערב אמרתי עכשיו אני רוצה


אמר לי אם כן בכאן | לא תמצא אפילו פרוטה אמרתי לו ומה עושה א״ל (=אמר לי) איני יודע 


ובאתי(?) אפליו (=אפילו) שכיר|ות סויס לא יש לי לפרוע חזרתי אצל הרב הנז׳ ופרע מכיסו


שכירות עלי אמר | לי תליך בזה הכתבים אצל חכם אחד שהיה בבית מעלים בכור


ותגיד לו כל העני|ן אפשר יכול לו ותקח ממנו הפוליסה אני יצאתי לילך אצלו


ותפסו אותי בעלי | הכראז (=خراج) והוליכו אותי לבית הסוהר בשביל שנה שלשית כי לא


היה בידי כי א|ם של שתי שנים שנת חמשים ושנת אחד וחמשים אמרתי לבעל


הכראז אלך [ל?]|אדם אחד עמי אצל היוהדים(!) ונפרע לך מה שהוא מסר(?) לי


ולא רצה להני|ח אותי וישבתי בעֿוֿה(?) בבית הסוהר שלושה ימים ושלושה לילות


והייתי ישן ע|ל גבי קרקע וחזר לי צנים פינים(?) וחולי עינים ביום ו׳ כתבתי כתב ליד

